1 0 0 1 3
2 0 0 0 0
4 0 2 4 0
0 5 5 0 0
0 0 0 0 3